1111111111
1P00000001
1011111101
1C000000C1
1010110101
1C000000C1
1111111111
