1111111111
10000000E1
1011111101
1C000000C1
1010110101
1C000000C1
1111111111