1111111111111111111111111111111111
1110011111111111111111111111111111
11EP0000CCCCCCCCCCCCCCCC0000000111
1100111101111111111110111111011111
1100000100000000000000100000000011
1111110101111111111110101111111011
1100011000000001000011000000000011
1101111111111101010111111111111011
1111111111111111111111111111111111