11111111111111111111111111111111
1P00C0000001000000100000000C00E1
10111110101011111010101111110111
10000000001000G00010100000000001
11111011010111111011010110111111
10000100C000G0G0000000C100000011
10110111111010101011111110110111
10100000C00000000000000C00010001
10101111101111111011110111010111
11111111111111111111111111111111