111111111111111111111111111111111111
1P0000C00000000000C0000000C0000000E1
1011110111110111110111110111110111S1
1C0000100000100000C000010000010000C1
101011010111010111011101011101010111
1G0010000C0000100000100000C0000100G1
111101101110111101111110111101111101
1C0000C0000000000G0000000000C00000C1
101111011111011111011111011111011101
1000001000C0000100000C000010000010G1
101011111011111011111011111011111011
1C000000G0000000C0000000G0000000C011
101111111111011111111111011111111001
1C0000000C000000G0000000C0000000C011
111111111111111111111111111111111111
