11111111111111111111111111111111
1P0000000C0000000000000000000C01
10111011101110111110111011101111
10000010001000G0G0001000100000G1
11111010101111CCC111101010111111
100G00000001000GCG00010000000001
10111111101111CCC111101111111011
1G0C0000001000G0G0001000000000G1
11101111111110111110111111101111
1G100000000000000000000000001001
1G101111101111111110111110101111
1G100000001000G0G0001000000100G1
11111011111111CCC111111011111011
1CG00000000000GCG0G000G000000SE1
11111111111111111111111111111111